natural	kana	kana(alternative)
x	ッ
a	ア
i	イ
u	ウ
e	エ
o	オ
i)	イ
a>	ァ
i>	ィ
u>	ゥ
e>	ェ
o>	ォ
fa	ヷ	ヴァ
fi	ヸ	ヴィ
fu	ヴ
fe	ヹ	ヴェ
fo	ヺ	ヴォ
ka	カ
ki	キ
ku	ク
ke	ケ
ko	コ
k)	ㇰ	ク
ga	ガ
gi	ギ
gu	グ
ge	ゲ
go	ゴ
sa	サ
si	シ
su	ス
se	セ
so	ソ
s)	ㇲ	ス
ja	ザ
ji	ジ
ju	ズ
je	ゼ
jo	ゾ
ca	ツァ
ci	チ
cu	ツ
ce	ツェ
co	ツォ
c)	ツ
ta	タ
ti	ティ
tu	トゥ
te	テ
to	ト
da	ダ
di	ディ
du	ドゥ
de	デ
do	ド
ha	ハ
hi	ヒ
hu	フ
he	ヘ
ho	ホ
h)	ㇷ	フ
ba	バ
bi	ビ
bu	ブ
be	ベ
bo	ボ
pa	パ
pi	ピ
pu	プ
pe	ペ
po	ポ
ma	マ
mi	ミ
mu	ム
me	メ
mo	モ
m)	ㇺ	ム
nla	ナ
nli	ニ
nlu	ヌ
nle	ネ
nlo	ノ
la	ラ
li	リ
lu	ル
le	レ
lo	ロ
ya	ヤ
yi	ユィ	イィ
yu	ユ
ye	ユェ	イェ
yo	ヨ
wa	ワ
wi	ヰ
wu	ヲゥ	ウゥ
we	ヱ
wo	ヲ
wa)	ヮ
nn	ン
n)	ン
nm)	ㇺ	ン
cji	ヂ
cju	ヅ
fha	ファ
fhi	フィ
fhu	フ
fhe	フェ
fho	フォ
bwa	ヷ	ヴァ
bwi	ヸ	ヴィ
bwu	ヴ
bwe	ヹ	ヴェ
bwo	ヺ	ヴォ
wyu	ウュ
fya	ヴャ
fyu	ヴュ
fyo	ヴョ
kya	キャ
kyu	キュ
kyo	キョ
kwa	クヮ
gya	ギャ
gyu	ギュ
gyo	ギョ
gwa	グヮ
sya	シャ
syu	シュ
syo	ショ
jya	ジャ
jyu	ジュ
jyo	ジョ
cya	チャ
cyu	チュ
cyo	チョ
cjya	ヂャ
cjyu	ヂュ
cjyo	ヂョ
tyu	テュ
dyu	デュ
hya	ヒャ
hyu	ヒュ
hyo	ヒョ
bya	ビャ
byu	ビュ
byo	ビョ
pya	ピャ
pyu	ピュ
pyo	ピョ
mya	ミャ
myu	ミュ
myo	ミョ
nlya	ニャ
nlyu	ニュ
nlyo	ニョ
lya	リャ
lyu	リュ
lyo	リョ
fhya	フャ
fhyu	フュ
fhyo	フョ
bwya	ヴャ
bwyu	ヴュ
bwyo	ヴョ
-	ー/イ/ウ/あ/い/う
~	え/お
_	ぁ/ぃ/ぅ/ぇ/ぉ
wa~	ほ
wo~	を
X	っ
A	あ
I	い
U	う
E	え
O	お
WO	を
I)	い
U)	う
Fu	ゔ
Ka	か
Ki	き
Ku	く
Ke	け
Ko	こ
KGa	か
KGe	け
KGo	こ
Ga	が
Gi	ぎ
Gu	ぐ
Ge	げ
Go	ご
Sa	さ
Si	し
Su	す
Se	せ
So	そ
S	す
Ja	ざ
Ji	じ
Ju	ず
Je	ぜ
Jo	ぞ
Ci	ち
Cu	つ
C	つ
CJi	ぢ
CJu	づ
Ta	た
Te	て
To	と
TDa	た
TDe	て
TDo	と
Da	だ
De	で
Do	ど
Ha	は
Hi	ひ
Hu	ふ
He	へ
Ho	ほ
HE	へ
Yhe	へ
Whe	へ
Ba	ば
Bi	び
Bu	ぶ
Be	べ
Bo	ぼ
Pa	ぱ
Pi	ぴ
Pu	ぷ
Pe	ぺ
Po	ぽ
Ma	ま
Mi	み
Mu	む
Me	め
Mo	も
Maui	ま
NLa	な
NLi	に
NLu	ぬ
NLe	ね
NLo	の
La	ら
Li	り
Lu	る
Le	れ
Lo	ろ
Ya	や
Yi	ゆい
Yu	ゆ
Ye	いぇ
Yo	よ
Wa	わ
Wi	ゐ
We	ゑ
Wo	を
Wha	は
Nn	ん
N)	ん
Nm)	ん
Fhu	ふ
Kya	きゃ
Kyu	きゅ
Kyo	きょ
Gya	ぎゃ
Gyu	ぎゅ
Gyo	ぎょ
Sya	しゃ
Syu	しゅ
Syo	しょ
Jya	じゃ
Jyu	じゅ
Jyo	じょ
Cya	ちゃ
Cyu	ちゅ
Cyo	ちょ
CJya	ぢゃ
CJyu	ぢゅ
CJyo	ぢょ
Hya	ひゃ
Hyu	ひゅ
Hyo	ひょ
Bya	びゃ
Byu	びゅ
Byo	りょ
Pya	ぴゃ
Pyu	ぴゅ
Pyo	ぴょ
Mya	みゃ
Myu	みゅ
Myo	みょ
NLya	にゃ
NLyu	にゅ
NLyo	にょ
Lya	りゃ
Lyu	りゅ
Lyo	りょ
